11111111111111111111
10000000000000000001
10111110111110111101
10100010100010100001
10101110101011101001
10101000101010101001
10101011101010111001
10100000000000001001
1011111011111011E001
11111111111111111111
